*..*.+....
..*..*....
*....*....
..***.....
.....**.**
S..+.*....
.....***..
******....
..E.*+....
......**..